'G:/DiscordBot/ErniesChairPy/sounds/SimpleAudio/'FakeDoors.wav	["Door","door"]	"Fake Doors"
'G:/DiscordBot/ErniesChairPy/sounds/SimpleAudio/'OMg.wav	["OMG", "omg", "Scarra", "scarra"]	'Scarra OMG'
'G:/DiscordBot/ErniesChairPy/sounds/SimpleAudio/'WhattTtTt.wav	["what","What","WHAT"]	'What!!'
'G:/DiscordBot/ErniesChairPy/sounds/SimpleAudio/'Same.wav	["same","Same","sneaky"]	'Same'
'G:/DiscordBot/ErniesChairPy/sounds/SimpleAudio/'Ezreal.taunt.ogg	["EZ","Ez","Easy","easy","Ezreal","ezreal"]	'Ez'
'G:/DiscordBot/ErniesChairPy/sounds/SimpleAudio/'nicememe.mp3	["nice","Nice","meme","Meme"]	'Meme'
'G:/DiscordBot/ErniesChairPy/sounds/SimpleAudio/'man handled.mp3	["Man","man","Handled","handle","Handle","handle"]	'Man Handled'
'G:/DiscordBot/ErniesChairPy/sounds/SimpleAudio/'back of the map.wav	["Back","back","Map","map"]	'BackofMap'
'G:/DiscordBot/ErniesChairPy/sounds/SimpleAudio/'Aww Sweet.wav	["Sweet","sweet"]	'AwwSweet'
'G:/DiscordBot/ErniesChairPy/sounds/SimpleAudio/'Opsal/cause im a bitch.wav	["im a bitch","Im a bitch","Im a Bitch","i'm a bitch","I'm a bitch","I'm a Bitch"]	'ImaBitch'
'G:/DiscordBot/ErniesChairPy/sounds/SimpleAudio/'Opsal/fucking got em.mp3	["Got Em","got em","Got him"]	'GotEm'
'G:/DiscordBot/ErniesChairPy/sounds/SimpleAudio/'Opsal/calp clap clap.wav	["Clap Clap","Clap Clap Clap","clap clap","clap clap clap"]	'ClapClap'
'G:/DiscordBot/ErniesChairPy/sounds/SimpleAudio/'Opsal/good shit.mp3	["good shit","Good Shit"]	'GoodShit'
'G:/DiscordBot/ErniesChairPy/sounds/SimpleAudio/'Opsal/Im Confused.wav	["Im Confused","Im confused","I'm confused","I'm Confused","confused","Confused"]	'ImConfused'
'G:/DiscordBot/ErniesChairPy/sounds/SimpleAudio/'Alex/dude that was like the worst ive ever seen.mp3	["worst ever","Worst Ever","Worst Ever"]	'WorstEver'
'G:/DiscordBot/ErniesChairPy/sounds/SimpleAudio/'Alex/it was really bad.wav	["Really Bad","really bad","Really bad"]	'ReallyBad'
'G:/DiscordBot/ErniesChairPy/sounds/SimpleAudio/'Alex/unlucky.wav	["unlucky","Unlucky"]	'Unlucky'
'G:/DiscordBot/ErniesChairPy/sounds/SimpleAudio/'Austin/oh god this fucking scrub.wav	["Scrub","scrub"]	'ThisScrub'
'G:/DiscordBot/ErniesChairPy/sounds/SimpleAudio/'Daniel/consider yourself lucky.wav	["Lucky"]	'ConsiderLucky'
'G:/DiscordBot/ErniesChairPy/sounds/SimpleAudio/'Daniel/hello.wav	["Hello","hello"]	'DanielHello'
'G:/DiscordBot/ErniesChairPy/sounds/SimpleAudio/'Daniel/got something on your mind opsal.wav	["Mind","mind"]	'OnYourMind'
'G:/DiscordBot/ErniesChairPy/sounds/SimpleAudio/'Ernie/ernie with his fat stacks.wav	["Stacks","stacks"]	'FatStacks'
'G:/DiscordBot/ErniesChairPy/sounds/SimpleAudio/'Ernie/it might have been my chair.mp3	["MightHaveBeen"]	'MightHaveBeen'
'G:/DiscordBot/ErniesChairPy/sounds/SimpleAudio/'Zak Barker/scott will provide.wav	["provide","Provide"]	'Provide'
'G:/DiscordBot/ErniesChairPy/sounds/SimpleAudio/'Zak Barker/youre a bitch.wav	["youre a bitch","Youre a bitch","Youre a Bicth","you're a bitch","You're a bitch","You're a Bitch"]	'YoureABitch'
'G:/DiscordBot/ErniesChairPy/sounds/SimpleAudio/'Scott/cause im not trying to be classy.wav	["Classy","classy"]	'NotClassy'
'G:/DiscordBot/ErniesChairPy/sounds/SimpleAudio/'Scott/fucking despise you.mp3	["Despise","despise"]	'DespiseYou'
'G:/DiscordBot/ErniesChairPy/sounds/SimpleAudio/'Scott/i hate you daniel.mp3	["Hate Daniel","hate daniel","hate Daniel"]	'HateDaniel'
'G:/DiscordBot/ErniesChairPy/sounds/SimpleAudio/'Scott/rip alex.wav	["RIP Alex","rip alex","Rip Alex","rip Alex"]	'RipAlex'
'G:/DiscordBot/ErniesChairPy/sounds/SimpleAudio/'Scott/thanks for the imput.wav	["Input","input"]	'ThanksInput' 
'G:/DiscordBot/ErniesChairPy/sounds/SimpleAudio/'utini.mp3	["Utini","utini"]	'Utini'
'G:/DiscordBot/ErniesChairPy/sounds/SimpleAudio/'Holy/Chalupa.mp3	["Chalupa","chalupa"]	'Chalupa'
'G:/DiscordBot/ErniesChairPy/sounds/SimpleAudio/'PussyAss.mp3	["pussyass"]	'PussyAss' 
'G:/DiscordBot/ErniesChairPy/sounds/SimpleAudio/'watchyourmouth.mp3	["watch your mouth"]	'WatchMouth' 
'G:/DiscordBot/ErniesChairPy/sounds/SimpleAudio/'quack.mp3	["quack","Quack"]	'Quack' 
'G:/DiscordBot/ErniesChairPy/sounds/SimpleAudio/'Poopy.mp3	["Poopy"]	'Poopy'
'G:/DiscordBot/ErniesChairPy/sounds/SimpleAudio/'Austin/ImBad.mp3	["ImBad"]	'ImBad'
'G:/DiscordBot/ErniesChairPy/sounds/SimpleAudio/'Kumar/Kumar.mp3	["AustinKumar"]	'Kumar'
'G:/DiscordBot/ErniesChairPy/sounds/SimpleAudio/'Austin/Nooahh.mp3	["Nooahh"]	'Nooahh'
'G:/DiscordBot/ErniesChairPy/sounds/SimpleAudio/'Austin/OhGod.mp3	["OhGod"]	'OhGod'
'G:/DiscordBot/ErniesChairPy/sounds/SimpleAudio/'Austin/SnickSnake.mp3	["Snick Snake","snick snake"]	'SnickSnake'
'G:/DiscordBot/ErniesChairPy/sounds/SimpleAudio/'Austin/wtf.mp3	["wtf"]	'wtf'
'G:/DiscordBot/ErniesChairPy/sounds/SimpleAudio/'AccurateDepiction.mp3	["Accurate Depiction","accurate depiction"]	'AccurateDepiction'
'G:/DiscordBot/ErniesChairPy/sounds/SimpleAudio/'BatmanLaugh.mp3	["Batman Laugh"]	'BatmanLaugh'
'G:/DiscordBot/ErniesChairPy/sounds/SimpleAudio/'MattRecording.mp3	["Matt Recording"]	'MattRecording'
'G:/DiscordBot/ErniesChairPy/sounds/SimpleAudio/'MyLife.mp3	["My Life","my life"]	'MyLife'
'G:/DiscordBot/ErniesChairPy/sounds/SimpleAudio/'NotSuck.mp3	["Not Suck","not suck"]	'NotSuck'
'G:/DiscordBot/ErniesChairPy/sounds/SimpleAudio/'Ben/AwkwardForThem.mp3	["AwkwardForThem"]	'AwkwardForThem'
'G:/DiscordBot/ErniesChairPy/sounds/SimpleAudio/'Ben/BeatHimUp.mp3	["BeatHimUp"]	'BeatHimUp'
'G:/DiscordBot/ErniesChairPy/sounds/SimpleAudio/'Ben/Block.mp3	["Block"]	'Block'
'G:/DiscordBot/ErniesChairPy/sounds/SimpleAudio/'Ben/DeezNuts.mp3	["DeezNuts"]	'DeezNuts'
'G:/DiscordBot/ErniesChairPy/sounds/SimpleAudio/'Ben/Hello.mp3	["BenHello"]	'Hello'
'G:/DiscordBot/ErniesChairPy/sounds/SimpleAudio/'Ben/Ididit.mp3	["Ididit"]	'Ididit'
'G:/DiscordBot/ErniesChairPy/sounds/SimpleAudio/'Ben/ImCumming.mp3	["Im Cumming"]	'ImCumming'
'G:/DiscordBot/ErniesChairPy/sounds/SimpleAudio/'Ben/NoShits.mp3	["NoShits","noshits"]	'NoShits'
'G:/DiscordBot/ErniesChairPy/sounds/SimpleAudio/'Ben/NotVeryNice.mp3	["Not Very Nice","not very nice"]	'NotVeryNice'
'G:/DiscordBot/ErniesChairPy/sounds/SimpleAudio/'Ben/SupBitches.mp3	["Sup Bitches","sup bitches"]	'SupBitches'
'G:/DiscordBot/ErniesChairPy/sounds/SimpleAudio/'Ben/ThisIsAwkward.mp3	["ThisIsAwkward","this is awkward"]	'This Is Awkward'
'G:/DiscordBot/ErniesChairPy/sounds/SimpleAudio/'Ben/VoidBitch.mp3	["Void Bitch","void bitch"]	'VoidBitch'
'G:/DiscordBot/ErniesChairPy/sounds/SimpleAudio/'Daniel/ClearThis.mp3	["Clear This","clear this","!clear"]	'ClearThis'
'G:/DiscordBot/ErniesChairPy/sounds/SimpleAudio/'Daniel/FuckMatt.mp3	["FuckMatt","fuckmatt","Fuck Matt","fuck matt"]	'FuckMatt'
'G:/DiscordBot/ErniesChairPy/sounds/SimpleAudio/'Daniel/GoingIn.mp3	["Going In"]	'GoingIn'
'G:/DiscordBot/ErniesChairPy/sounds/SimpleAudio/'Daniel/GotEm.mp3	["DanielGotEm"]	'GotEm'
'G:/DiscordBot/ErniesChairPy/sounds/SimpleAudio/'Daniel/HaveToDoIt.mp3	["HaveToDoIt"]	'HaveToDoIt'
'G:/DiscordBot/ErniesChairPy/sounds/SimpleAudio/'Daniel/Hello.mp3	["DanielHello"]	'Hello'
'G:/DiscordBot/ErniesChairPy/sounds/SimpleAudio/'Daniel/IHaveFriends.mp3	["I Have Friends","I have friends"]	'IHaveFriends'
'G:/DiscordBot/ErniesChairPy/sounds/SimpleAudio/'Daniel/Iloveyou.mp3	["I love you"]	'Iloveyou'
'G:/DiscordBot/ErniesChairPy/sounds/SimpleAudio/'Kumar/Kumar.mp3	["DanielKumar"]	'Kumar'
'G:/DiscordBot/ErniesChairPy/sounds/SimpleAudio/'Kumar/LitKumar.mp3	["Lit Kumar"]	'LitKumar'
'G:/DiscordBot/ErniesChairPy/sounds/SimpleAudio/'Daniel/MattType.mp3	["Matt Type"]	'MattType'
'G:/DiscordBot/ErniesChairPy/sounds/SimpleAudio/'Dopkins/RIP Dopkins.mp3	["RIP Dobkins"]	'RIP Dopkins'
'G:/DiscordBot/ErniesChairPy/sounds/SimpleAudio/'Daniel/SoDeep.mp3	["So Deep"]	'SoDeep'
'G:/DiscordBot/ErniesChairPy/sounds/SimpleAudio/'Daniel/Triggered.mp3	["DanielTriggered"]	'Triggered'
'G:/DiscordBot/ErniesChairPy/sounds/SimpleAudio/'Dopkins/HateBarker.mp3	["HateBarker"]	'HateBarker'
'G:/DiscordBot/ErniesChairPy/sounds/SimpleAudio/'Dopkins/HowsItGoing.mp3	["HowsItGoing"]	'HowsItGoing'
'G:/DiscordBot/ErniesChairPy/sounds/SimpleAudio/'Ernie/Achievment.mp3	["Achievement"]	'Achievment'
'G:/DiscordBot/ErniesChairPy/sounds/SimpleAudio/'Ernie/BabyComeBack.mp3	["BabyComeBack"]	'BabyComeBack'
'G:/DiscordBot/ErniesChairPy/sounds/SimpleAudio/'Ernie/BigDick.mp3	["BigDick"]	'BigDick'
'G:/DiscordBot/ErniesChairPy/sounds/SimpleAudio/'Ernie/Cooking.mp3	["Cooking"]	'Cooking'
'G:/DiscordBot/ErniesChairPy/sounds/SimpleAudio/'Ernie/ErnieBreath.mp3	["Ernie Breath"]	'ErnieBreath'
'G:/DiscordBot/ErniesChairPy/sounds/SimpleAudio/'Ernie/Hello.mp3	["ErnieHello"]	'Hello'
'G:/DiscordBot/ErniesChairPy/sounds/SimpleAudio/'Ernie/HisAss.mp3	["His Ass"]	'HisAss'
'G:/DiscordBot/ErniesChairPy/sounds/SimpleAudio/'Ernie/LeagueGame.mp3	["League Game"]	'LeagueGame'
'G:/DiscordBot/ErniesChairPy/sounds/SimpleAudio/'Ernie/ObiWon.mp3	["ObiWon"]	'ObiWon'
'G:/DiscordBot/ErniesChairPy/sounds/SimpleAudio/'Ernie/TRiggered.mp3	["ErnieTriggered","ernietriggered"]	'TRiggered'
'G:/DiscordBot/ErniesChairPy/sounds/SimpleAudio/'Ernie/WheresThatAsshole.mp3	["WheresThatAsshole","wheresthatasshole"]	'WheresThatAsshole'
'G:/DiscordBot/ErniesChairPy/sounds/SimpleAudio/'Kumar/AssOutOfMe.mp3	["AssOutOfMe","assoutofme"]	'AssOutOfMe'
'G:/DiscordBot/ErniesChairPy/sounds/SimpleAudio/'Kumar/BarkerShit.mp3	["BarkerShit"]	'BarkerShit'
'G:/DiscordBot/ErniesChairPy/sounds/SimpleAudio/'Kumar/MattYoureABitch.mp3	["MattYoureABitch","mattyoureabitch"]	'MattYoureABitch'
'G:/DiscordBot/ErniesChairPy/sounds/SimpleAudio/'Kumar/NextTree.mp3	["Next Tree","next tree"]	'NextTree'
'G:/DiscordBot/ErniesChairPy/sounds/SimpleAudio/'Kumar/Old.mp3	["Old","old"]	'Old'
'G:/DiscordBot/ErniesChairPy/sounds/SimpleAudio/'Kumar/Push Into Em.mp3	["Push Into Em","push into em"]	'Push Into Em'
'G:/DiscordBot/ErniesChairPy/sounds/SimpleAudio/'Kumar/shit.mp3	["Kumar shit","kumar shit"]	'shit'
'G:/DiscordBot/ErniesChairPy/sounds/SimpleAudio/'Kyle/DoTheOpposite.mp3	["Do The Opposite","do the opposite"]	'DoTheOpposite'
'G:/DiscordBot/ErniesChairPy/sounds/SimpleAudio/'Kyle/GreenSlime.mp3	["Green Slime","green slime"]	'GreenSlime'
'G:/DiscordBot/ErniesChairPy/sounds/SimpleAudio/'Kyle/Mistake.mp3	["Mistake","mistake"]	'Mistake'
'G:/DiscordBot/ErniesChairPy/sounds/SimpleAudio/'Scott/BadPlayer.mp3	["Bad Player","bad player"]	'BadPlayer'
'G:/DiscordBot/ErniesChairPy/sounds/SimpleAudio/'Scott/BelieveIn.mp3	["Believe In","believe in"]	'BelieveIn'
'G:/DiscordBot/ErniesChairPy/sounds/SimpleAudio/'Scott/GoodUrkel.mp3	["Good Urkel"]	'GoodUrkel'
'G:/DiscordBot/ErniesChairPy/sounds/SimpleAudio/'Scott/Hello.mp3	["ScottHello"]	'Hello'
'G:/DiscordBot/ErniesChairPy/sounds/SimpleAudio/'Scott/HesTheLeader.mp3	["HesTheLeader","hes the leader"]	'HesTheLeader'
'G:/DiscordBot/ErniesChairPy/sounds/SimpleAudio/'Scott/ImBad.mp3	["ScottBad","scottbad"]	'ImBad'
'G:/DiscordBot/ErniesChairPy/sounds/SimpleAudio/'Scott/ImDaniel.mp3	["ImDaniel","imdaniel"]	'ImDaniel'
'G:/DiscordBot/ErniesChairPy/sounds/SimpleAudio/'Scott/LiveIt.mp3	["Live It","live it"]	'LiveIt'
'G:/DiscordBot/ErniesChairPy/sounds/SimpleAudio/'Scott/SayYourDaniel.mp3	["Say Youre Daniel","say you're Daniel","say you're daniel","say youre daniel"]	'SayYourDaniel'
'G:/DiscordBot/ErniesChairPy/sounds/SimpleAudio/'Sheep/Daniel!.mp3	["Daniel!"]	'Daniel!'
'G:/DiscordBot/ErniesChairPy/sounds/SimpleAudio/'Sheep/Dopkins.mp3	["Dobkins","dobkins"]	'Dopkins'
'G:/DiscordBot/ErniesChairPy/sounds/SimpleAudio/'Ben/GetOutBen.mp3	["Get Out Ben","get out ben"]	'GetOutBen'
'G:/DiscordBot/ErniesChairPy/sounds/SimpleAudio/'Sheep/Goodbye.mp3	["Goodbye","goodbye"]	'Goodbye'
'G:/DiscordBot/ErniesChairPy/sounds/SimpleAudio/'Sheep/GotEm.mp3	["SheepGotEm","Sheepgotem"]	'GotEm'
'G:/DiscordBot/ErniesChairPy/sounds/SimpleAudio/'Sheep/IsMattRecording.mp3	["Is Matt Recording","is matt recording"]	'IsMattRecording'
'G:/DiscordBot/ErniesChairPy/sounds/SimpleAudio/'Sheep/NoHeal.mp3	["No Heal","no heal"]	'NoHeal'
'G:/DiscordBot/ErniesChairPy/sounds/SimpleAudio/'Sheep/Ohhhhhh.mp3	["Ohhhhhh"]	'Ohhhhhh'
'G:/DiscordBot/ErniesChairPy/sounds/SimpleAudio/'Sheep/SucksToSuck.mp3	["Sucks To Suck","sucks to suck","Sucks to suck"]	'SucksToSuck'
'G:/DiscordBot/ErniesChairPy/sounds/SimpleAudio/'Sheep/What.mp3	["SheepWhat"]	'What'
'G:/DiscordBot/ErniesChairPy/sounds/SimpleAudio/'1000buks.mp3	["1000 bucks"]	'1000buks'
'G:/DiscordBot/ErniesChairPy/sounds/SimpleAudio/'37.wav	["37 dicks"]	'37'
'G:/DiscordBot/ErniesChairPy/sounds/SimpleAudio/'all2easy.mp3	["all 2 easy"]	'all2easy'
'G:/DiscordBot/ErniesChairPy/sounds/SimpleAudio/'ass.wav	["big ass"]	'ass'
'G:/DiscordBot/ErniesChairPy/sounds/SimpleAudio/'assholes.wav	["assholes"]	'assholes'
'G:/DiscordBot/ErniesChairPy/sounds/SimpleAudio/'badfeelg.wav	["bad feeling"]	'badfeelg'
'G:/DiscordBot/ErniesChairPy/sounds/SimpleAudio/'burger.wav	["burger"]	'burger'
'G:/DiscordBot/ErniesChairPy/sounds/SimpleAudio/'chosenone.wav	["chosen one"]	'chosenone'
'G:/DiscordBot/ErniesChairPy/sounds/SimpleAudio/'computer1.mp3	["computer"]	'computer1'
'G:/DiscordBot/ErniesChairPy/sounds/SimpleAudio/'concentr.mp3	["concentration"]	'concentr'
'G:/DiscordBot/ErniesChairPy/sounds/SimpleAudio/'constructive.mp3	["constructive"]	'constructive'
'G:/DiscordBot/ErniesChairPy/sounds/SimpleAudio/'denied.mp3	["denied"]	'denied'
'G:/DiscordBot/ErniesChairPy/sounds/SimpleAudio/'deservethat2.wav	["deservethat"]	'deservethat2'
'G:/DiscordBot/ErniesChairPy/sounds/SimpleAudio/'dicks.wav	["suck dicks"]	'dicks'
'G:/DiscordBot/ErniesChairPy/sounds/SimpleAudio/'disinclined.wav	["disinclined"]	'disinclined'
'G:/DiscordBot/ErniesChairPy/sounds/SimpleAudio/'disturbg.wav	["disturbing"]	'disturbg'
'G:/DiscordBot/ErniesChairPy/sounds/SimpleAudio/'figment.mp3	["figment"]	'figment'
'G:/DiscordBot/ErniesChairPy/sounds/SimpleAudio/'fire.mp3	["fire"]	'fire'
'G:/DiscordBot/ErniesChairPy/sounds/SimpleAudio/'flyfools.wav	["fly fools"]	'flyfools'
'G:/DiscordBot/ErniesChairPy/sounds/SimpleAudio/'forkeeps.mp3	["for keeps"]	'forkeeps'
'G:/DiscordBot/ErniesChairPy/sounds/SimpleAudio/'found.wav	["found"]	'found'
'G:/DiscordBot/ErniesChairPy/sounds/SimpleAudio/'getlaid.mp3	["get laid"]	'getlaid'
'G:/DiscordBot/ErniesChairPy/sounds/SimpleAudio/'happy10.wav	["price"]	'happy10'
'G:/DiscordBot/ErniesChairPy/sounds/SimpleAudio/'happy3.wav	["tap"]	'happy3'
'G:/DiscordBot/ErniesChairPy/sounds/SimpleAudio/'happy7.wav	["kick my ass"]	'happy7'
'G:/DiscordBot/ErniesChairPy/sounds/SimpleAudio/'ijustdontcare.mp3	["i just dont care"]	'ijustdontcare'
'G:/DiscordBot/ErniesChairPy/sounds/SimpleAudio/'impresiv.mp3	["impresive"]	'impresiv'
'G:/DiscordBot/ErniesChairPy/sounds/SimpleAudio/'inconceivable4.wav	["inconceivable"]	'inconceivable4'
'G:/DiscordBot/ErniesChairPy/sounds/SimpleAudio/'jarjar1.mp3	["jarjar"]	'jarjar1'
'G:/DiscordBot/ErniesChairPy/sounds/SimpleAudio/'mondays.wav	["mondays"]	'mondays'
'G:/DiscordBot/ErniesChairPy/sounds/SimpleAudio/'mostimprs.wav	["impressive"]	'mostimprs'
'G:/DiscordBot/ErniesChairPy/sounds/SimpleAudio/'mp1.mp3	["swallow"]	'mp1'
'G:/DiscordBot/ErniesChairPy/sounds/SimpleAudio/'myswamp.wav	["my swamp"]	'myswamp'
'G:/DiscordBot/ErniesChairPy/sounds/SimpleAudio/'neck.mp3	["neck"]	'neck'
'G:/DiscordBot/ErniesChairPy/sounds/SimpleAudio/'needhug.wav	["need a hug"]	'needhug'
'G:/DiscordBot/ErniesChairPy/sounds/SimpleAudio/'nproblem.mp3	["no problem"]	'nproblem'
'G:/DiscordBot/ErniesChairPy/sounds/SimpleAudio/'numnuts.mp3	["numnuts"]	'numnuts'
'G:/DiscordBot/ErniesChairPy/sounds/SimpleAudio/'ohnowesuckagain.mp3	["ohno we suck again"]	'ohnowesuckagain'
'G:/DiscordBot/ErniesChairPy/sounds/SimpleAudio/'quiteenough.mp3	["quite enough"]	'quiteenough'
'G:/DiscordBot/ErniesChairPy/sounds/SimpleAudio/'runshadowfax.wav	["runshadowfax"]	'runshadowfax'
'G:/DiscordBot/ErniesChairPy/sounds/SimpleAudio/'scumbag.mp3	["scumbag"]	'scumbag'
'G:/DiscordBot/ErniesChairPy/sounds/SimpleAudio/'serioustherapy.wav	["serious therapy"]	'serioustherapy'
'G:/DiscordBot/ErniesChairPy/sounds/SimpleAudio/'serveyouwell.mp3	["serve you well"]	'serveyouwell'
'G:/DiscordBot/ErniesChairPy/sounds/SimpleAudio/'sister.mp3	["sister"]	'sister'
'G:/DiscordBot/ErniesChairPy/sounds/SimpleAudio/'socialskills.mp3	["social skills"]	'socialskills'
'G:/DiscordBot/ErniesChairPy/sounds/SimpleAudio/'technicl.wav	["technical"]	'technicl'
'G:/DiscordBot/ErniesChairPy/sounds/SimpleAudio/'tossdwarf.wav	["dwarf toss"]	'tossdwarf'
'G:/DiscordBot/ErniesChairPy/sounds/SimpleAudio/'twirp.wav	["twirp"]	'twirp'
'G:/DiscordBot/ErniesChairPy/sounds/SimpleAudio/'waiting.wav	["waiting"]	'waiting'
'G:/DiscordBot/ErniesChairPy/sounds/SimpleAudio/'wanttodie.mp3	["want to die"]	'wanttodie'
'G:/DiscordBot/ErniesChairPy/sounds/SimpleAudio/'whatjunk.mp3	["what junk"]	'whatjunk'
'G:/DiscordBot/ErniesChairPy/sounds/SimpleAudio/'youreawizard.wav	["youre a wizard"]	'youreawizard'
'G:/DiscordBot/ErniesChairPy/sounds/SimpleAudio/'youshallnotpasss.wav	["you shall not pass"]	'youshallnotpasss'
'G:/DiscordBot/ErniesChairPy/sounds/SimpleAudio/'anakin.mp3	["anakin"]	'anakin'
'G:/DiscordBot/ErniesChairPy/sounds/SimpleAudio/'disqualified.mp3	["disqualified"]	'disqualified'
'G:/DiscordBot/ErniesChairPy/sounds/SimpleAudio/'DoIt.mp3	["Do it","do it","Do It"]	'DoIt'
'G:/DiscordBot/ErniesChairPy/sounds/SimpleAudio/'Hanzo.mp3	["Hanzo"]	'Hanzo'
'G:/DiscordBot/ErniesChairPy/sounds/SimpleAudio/'itsatrap.mp3	["its a trap"]	'itsatrap'
'G:/DiscordBot/ErniesChairPy/sounds/SimpleAudio/'kogmawtantantan.mp3	["kogmaw"]	'kogmawtantantan'
'G:/DiscordBot/ErniesChairPy/sounds/SimpleAudio/'MattYes.mp3	["Matt Yes","Matt yes","matt yes"]	'MattYes'
'G:/DiscordBot/ErniesChairPy/sounds/SimpleAudio/'meeseeks.mp3	["meeseeks"]	'meeseeks'
'G:/DiscordBot/ErniesChairPy/sounds/SimpleAudio/'MyMan.mp3	["My Man","my man"]	'MyMan'
'G:/DiscordBot/ErniesChairPy/sounds/SimpleAudio/'nope.mp3	["nope"]	'nope'
'G:/DiscordBot/ErniesChairPy/sounds/SimpleAudio/'sadtrombone.mp3	["sad trombone"]	'sadtrombone'
'G:/DiscordBot/ErniesChairPy/sounds/SimpleAudio/'Siren.mp3	["Siren,siren,Firetruck,firetruck"]	'Siren'
'G:/DiscordBot/ErniesChairPy/sounds/SimpleAudio/'weed.mp3	["weed"]	'weed'
'G:/DiscordBot/ErniesChairPy/sounds/SimpleAudio/'Wololo.mp3	["Wololo","wololo"]	'Wololo'
'G:/DiscordBot/ErniesChairPy/sounds/SimpleAudio/'wubalubadubdubs-rick-and-morty.mp3	["wubalubadubdubs"]	'wubalubadubdubs-rick-and-morty'
'G:/DiscordBot/ErniesChairPy/sounds/SimpleAudio/'Yasuo.mp3	["Yasuo"]	'Yasuo'
'G:/DiscordBot/ErniesChairPy/sounds/SimpleAudio/'MatthewJoseph.mp3	["Matthew Joseph","matthew joseph"]	'MatthewJoseph'
'G:/DiscordBot/ErniesChairPy/sounds/SimpleAudio/'DingDong.mp3	["Ding Dong","ding dong"]	'DingDong'
'G:/DiscordBot/ErniesChairPy/sounds/SimpleAudio/'YaNasty.mp3	["Ya Nasty","ya nasty"]	'YaNasty'
'G:/DiscordBot/ErniesChairPy/sounds/SimpleAudio/'YoureWelcome.mp3	["Youre Welcome","youre welcome"]	'YoureWelcome'
'G:/DiscordBot/ErniesChairPy/sounds/SimpleAudio/'XD.mp3	["XD"]	'XD'
'G:/DiscordBot/ErniesChairPy/sounds/SimpleAudio/'ThatsAnnoying.mp3	["ThatsAnnoying"]	'ThatsAnnoying'
'G:/DiscordBot/ErniesChairPy/sounds/SimpleAudio/'PlantLol.mp3	["Plantlol"]	'PlantLol'
'G:/DiscordBot/ErniesChairPy/sounds/SimpleAudio/'BeMe.mp3	["Be Me","be me"]	'BeMe'
'G:/DiscordBot/ErniesChairPy/sounds/SimpleAudio/'BeYou.mp3	["Be You","be you"]	'BeYou'
'G:/DiscordBot/ErniesChairPy/sounds/SimpleAudio/'BigBoy.mp3	["Big Boy","big boy"]	'BigBoy'
'G:/DiscordBot/ErniesChairPy/sounds/SimpleAudio/'BigWoop.mp3	["Big Woop","big woop"]	'BigWoop'
'G:/DiscordBot/ErniesChairPy/sounds/SimpleAudio/'Bwahlala.mp3	["Bwahlala","bwahlala"]	'Bwahlala'
'G:/DiscordBot/ErniesChairPy/sounds/SimpleAudio/'CanAndWill.mp3	["Can And Will","can And will"]	'CanAndWill'
'G:/DiscordBot/ErniesChairPy/sounds/SimpleAudio/'ClownCiesta.mp3	["Clown Ciesta","clown ciesta"]	'ClownCiesta'
'G:/DiscordBot/ErniesChairPy/sounds/SimpleAudio/'DickBigger.mp3	["DickBigger","dickbigger"]	'DickBigger'
'G:/DiscordBot/ErniesChairPy/sounds/SimpleAudio/'DidntInvite.mp3	["Didnt Invite","didnt invite","Didn't Invite","didn't invite","Didn't invite","Didn't invite"]	'DidntInvite'
'G:/DiscordBot/ErniesChairPy/sounds/SimpleAudio/'Discord.mp3	["Discord","discord"]	'Discord'
'G:/DiscordBot/ErniesChairPy/sounds/SimpleAudio/'DontTalkAboutMyDick.mp3	["Dont talk about my dick","dont talk about my dick"]	'DontTalkAboutMyDick'
'G:/DiscordBot/ErniesChairPy/sounds/SimpleAudio/'DSJLeagueGame.mp3	["DSJLeagueGame","DSJ League Game"]	'DSJLeagueGame'
'G:/DiscordBot/ErniesChairPy/sounds/SimpleAudio/'DyingSlowly.mp3	["Dying Slowly","dying slowly"]	'DyingSlowly'
'G:/DiscordBot/ErniesChairPy/sounds/SimpleAudio/'EatAss.mp3	["EatAss"]	'EatAss'
'G:/DiscordBot/ErniesChairPy/sounds/SimpleAudio/'FakeTits.mp3	["FakeTits"]	'FakeTits'
'G:/DiscordBot/ErniesChairPy/sounds/SimpleAudio/'FeelsGood.mp3	["Feels Good"]	'FeelsGood'
'G:/DiscordBot/ErniesChairPy/sounds/SimpleAudio/'Free.mp3	["Free!"]	'Free'
'G:/DiscordBot/ErniesChairPy/sounds/SimpleAudio/'FuckMeEveryTime.mp3	["FuckMeEveryTime"]	'FuckMeEveryTime'
'G:/DiscordBot/ErniesChairPy/sounds/SimpleAudio/'FuckThatShit.mp3	["FuckThatShit"]	'FuckThatShit'
'G:/DiscordBot/ErniesChairPy/sounds/SimpleAudio/'FuckYouAustin.mp3	["FuckYouAustin"]	'FuckYouAustin'
'G:/DiscordBot/ErniesChairPy/sounds/SimpleAudio/'FuckYouMe.mp3	["FuckYouMe"]	'FuckYouMe'
'G:/DiscordBot/ErniesChairPy/sounds/SimpleAudio/'GetFucked.mp3	["GetFucked"]	'GetFucked'
'G:/DiscordBot/ErniesChairPy/sounds/SimpleAudio/'GetMeThings.mp3	["GetMeThings","get me things"]	'GetMeThings'
'G:/DiscordBot/ErniesChairPy/sounds/SimpleAudio/'GoodJobScott.mp3	["Good Job Scott","good job Scott","good job scott"]	'GoodJobScott'
'G:/DiscordBot/ErniesChairPy/sounds/SimpleAudio/'GotYouScott.mp3	["Got You Scott","got you scott","got you Scott"]	'GotYouScott'
'G:/DiscordBot/ErniesChairPy/sounds/SimpleAudio/'HolyFuck.mp3	["HolyFuck"]	'HolyFuck'
'G:/DiscordBot/ErniesChairPy/sounds/SimpleAudio/'IFuckYou.mp3	["IFuckYou"]	'IFuckYou'
'G:/DiscordBot/ErniesChairPy/sounds/SimpleAudio/'ImPissed.mp3	["ImPissed"]	'ImPissed'
'G:/DiscordBot/ErniesChairPy/sounds/SimpleAudio/'InThisBush.mp3	["InThisBush"]	'InThisBush'
'G:/DiscordBot/ErniesChairPy/sounds/SimpleAudio/'IsThatMe.mp3	["IsThatMe"]	'IsThatMe'
'G:/DiscordBot/ErniesChairPy/sounds/SimpleAudio/'Jaba.mp3	["Jaba","jaba"]	'Jaba'
'G:/DiscordBot/ErniesChairPy/sounds/SimpleAudio/'LickMyBalls.mp3	["LickMyBalls"]	'LickMyBalls'
'G:/DiscordBot/ErniesChairPy/sounds/SimpleAudio/'LookBad.mp3	["LookBad"]	'LookBad'
'G:/DiscordBot/ErniesChairPy/sounds/SimpleAudio/'MeHello.mp3	["MeHello"]	'MeHello'
'G:/DiscordBot/ErniesChairPy/sounds/SimpleAudio/'MyOhAhhh.mp3	["MyOhAhhh"]	'MyOhAhhh'
'G:/DiscordBot/ErniesChairPy/sounds/SimpleAudio/'NotGoingToSayAnything.mp3	["NotGoingToBeMe"]	'NotGoingToSayAnything'
'G:/DiscordBot/ErniesChairPy/sounds/SimpleAudio/'ohhhahhh.mp3	["ohhhahhh"]	'ohhhahhh'
'G:/DiscordBot/ErniesChairPy/sounds/SimpleAudio/'OneMeme.mp3	["One Meme"]	'OneMeme'
'G:/DiscordBot/ErniesChairPy/sounds/SimpleAudio/'PositiveCommunity.mp3	["Positive Community","positive community"]	'PositiveCommunity'
'G:/DiscordBot/ErniesChairPy/sounds/SimpleAudio/'ProudOfYou.mp3	["Proud Of You","proud of you"]	'ProudOfYou'
'G:/DiscordBot/ErniesChairPy/sounds/SimpleAudio/'PutItOn.mp3	["put it on"]	'PutItOn'
'G:/DiscordBot/ErniesChairPy/sounds/SimpleAudio/'ShutUpScott.mp3	["ShutUpScott"]	'ShutUpScott'
'G:/DiscordBot/ErniesChairPy/sounds/SimpleAudio/'Sick.mp3	["Sick","sick"]	'Sick'
'G:/DiscordBot/ErniesChairPy/sounds/SimpleAudio/'Sigh.mp3	["Sigh"]	'Sigh'
'G:/DiscordBot/ErniesChairPy/sounds/SimpleAudio/'SoMany.mp3	["SoMany","somany"]	'SoMany'
'G:/DiscordBot/ErniesChairPy/sounds/SimpleAudio/'ThanksBud.mp3	["Thanks Bud","thanks bud"]	'ThanksBud'
'G:/DiscordBot/ErniesChairPy/sounds/SimpleAudio/'ThanksMe.mp3	["Thanks Me","thanks me"]	'ThanksMe'
'G:/DiscordBot/ErniesChairPy/sounds/SimpleAudio/'ThatsWhatImSaying.mp3	["Thats What Im Saying","thats what im saying"]	'ThatsWhatImSaying'
'G:/DiscordBot/ErniesChairPy/sounds/SimpleAudio/'TopNotch.mp3	["top notch"]	'TopNotch'
'G:/DiscordBot/ErniesChairPy/sounds/SimpleAudio/'Uhohah.mp3	["Uhohah"]	'Uhohah'
'G:/DiscordBot/ErniesChairPy/sounds/SimpleAudio/'Wacked.mp3	["Wacked","wacked"]	'Wacked'
'G:/DiscordBot/ErniesChairPy/sounds/SimpleAudio/'WannaDoCombos.mp3	["Wanna Do Combos","wanna do combos"]	'WannaDoCombos'
'G:/DiscordBot/ErniesChairPy/sounds/SimpleAudio/'WeDontDoThat.mp3	["WeDontDoThat"]	'WeDontDoThat'
'G:/DiscordBot/ErniesChairPy/sounds/SimpleAudio/'WhatDidIDo.mp3	["WhatDidIDo"]	'WhatDidIDo'
'G:/DiscordBot/ErniesChairPy/sounds/SimpleAudio/'WhosReal.mp3	["Whos Real","whos real"]	'WhosReal'
'G:/DiscordBot/ErniesChairPy/sounds/SimpleAudio/'WorkingFields.mp3	["working fields","Working Fields"]	'WorkingFields'
'G:/DiscordBot/ErniesChairPy/sounds/SimpleAudio/'YelledAt.mp3	["Yelled At","yelled at"]	'YelledAt'
'G:/DiscordBot/ErniesChairPy/sounds/SimpleAudio/'YeYeaH.mp3	["YeYeaH"]	'YeYeaH'
'G:/DiscordBot/ErniesChairPy/sounds/SimpleAudio/'YouKnowWhat.mp3	["YouKnowWhat"]	'YouKnowWhat'
'G:/DiscordBot/ErniesChairPy/sounds/SimpleAudio/'PlantBirthday.mp3	["Plant Birthday","Plant birthday","plant birthday","PlantBirthday"]	'PlantBirthday'
'G:/DiscordBot/ErniesChairPy/sounds/SimpleAudio/'Cat.mp3	["Cat","cat"]	'Cat'