Kumar	Customers
DSJ	Customers
SpankinMuffin	Customers
Roreik	Customers
Plant	Customers,NotTilted,Weeb Overlord,BigDick Playa
CaptainCalpin	Customers
Mee6	Mee6
Kinz	Customers
Bem	Customers
Ninjalarry	Customers
Lone Wolf	Customers
Sissynerd	Customers,NotTilted,Weeb Overlord,BigDick Playa
NamiWetDreams	Disney
DisneyFanboy	Disney
stiglitz	Customers
Cogdor	Customers
Narod	Valued Customer
Pimp Master Grant	Customers
Tpz200	Customers
Kherax	Customers
Fancybritches	NotTilted
Vixerox	Kicked By Lindsey
Kregis	Customers
jake	Customers
Kitch	Customers
SVP Para Bellum	Customers
tneigut	Customers
screenmonkey228	Customers
Drells	Customers
RedBeard	Customers
Sissynerd	Teir2
Fancybritches	Teir2,Tier 1